WWWW999999WWWW
WFFWWWWWWWWFFW
WRFRFFFFFRFRFW
W0B0B0B0B0B0BW
WB0B0BSB0B0B0W
W0B0B0B0B0B0BW
WB0B0B0B0B0B0W
WFRFRFFFFFRFRW
WFFWWWWWWWWFFW
WWWW999999WWWW