9WWWWWWWWWWWWWW9
9W0S0R0R0R0W00WW
9WBW00R0R00W000W
9W0W0R0R0R00000W
9W0W00R0R00WW0WW
9W0W0R0R0R0WW0W9
9W0W00R0R00WW0W9
9W0W0R0R0R0WW0W9
9W0W00R0R00WW0W9
9W0W0R0F0R0WW0WW
WW0WWWWWWWWWW00W
W00000000000000W
W000WWWWWWWWW00W
WWWWW9999999WWWW
