9WWWWWW9
WW0000WW
W0B0BB0W
WFFFFFFW
W0BB0B0W
WWW0SWWW
99WWWW99