999WWWWW9
WWWWF00WW
W0BFBF00W
WSBW0WB0W
W0BF0F00W
WWWWBWB0W
99WF0F00W
99WWWWWWW