99WWWWW99
99W0S0W99
99W0B0W99
WWW0F0WWW
W000R000W
W0RRRRR0W
W000R000W
WWWBRBWWW
99W0F0W00
99W0R0W99
99W0F0W99
99WWWWW99