WWWWW9WWWW999999
WFFFW9W00WWWW999
WFFFWWW00B00W999
WFFFFWW0B00BWWW9
WWFFFFWW000B00W9
WWWFFF0WW0B0B0W9
W0WW0000W00B00W9
W00WW0W0WWW0WWWW
W0B0W0WB00B0000W
W00BS00B0000B00W
W000W0B0BB0B0WWW
W00WWWWWW00WWW99
W0WW9999WWWW9999
WWW99999WWWW9999