9999999WWWW999
WWWWWWWW00WWWW
W000WWFFFFF00W
W00B00WWFFFW0W
WW00B00WWW0W0W
9W0W0B00W0000W
9W00W0B00W000W
9W000W0B00W00W
9W0000W0B0W0WW
9WWWW00W0B00W9
9999WW00W0B0W9
99999WWSW000W9
999999WWWWWWW9
99999999999999