99999WWWW9999
WWWWWW00WWWWW
WSB0000B00B0W
WBWWW0B0W0W0W
W00W00W0B000W
W0BW0000W0WWW
W00B0WBW000W9
WFFFFFFFFF0W9
WWWWWWWW000W9
9999999WWWWW9