99999WWWWW
9WWWWW000W
9W0FF0BW0W
9W0WFR000W
WW0RFWB0WW
W0B00B00W9
W000WW0SW9
WWWWWWWWW9