WWWWW9999
W000W9999
W0B0W9WWW
W0BSW9WFW
WWWBWWWFW
9WW0000FW
9W000W00W
9W000WWWW
9WWWWW999