999999WWWWW99999
WWWWWWW000W99999
W000WWF000W99999
W00BWFF00WWW9999
WW00FFFWBB0WWWWW
9W0BFWFB0000000W
9W0BWWWBWW0W0B0W
9W000W00000BBW0W
9WWBBW0WWBWB000W
9WFFF0BS0B000WWW
9WFFFWBW000WWW99
9WFFF00WWWWW9999
9WWWWWWW99999999