WWWWWW999
W0000W999
W0B00WWWW
W0BRFFR0W
W0RFFRB0W
WWWW00B0W
999W00S0W
999WWWWWW