99WWWWWW
99W0000W
WWWBBB0W
WS0BFF0W
W0BFFF0W
WWWW00W9
999WWWW9