ULULULULULUURRDRDRDRDRDRRLDDRRUUUUURULDLUUUDDRRUUU
LLLLLRRRDDDRDDDDLLDRDRUUUUURULDLUUUDDRRUUULLLLRRDD
DRDDDDLLLULULULULUURDRDRDRDRDULULULULLDRDRDRDRDRRD
RUUUURULDLUUUDDRRUUULLDLLUURDRDDDRDDDDLLLULULULUUR
DRDRDRDULULULLDRDRDRDRRDRUUUURULDLUUUDDRRUUULLLULD
RRDDDRDDDDLLLULULUURDRDRDULULLDRDRDRRDRUUUURULDLUU
UDDRRUUULLLRDDDRDDDDLLLULUURDRDDUULLDRURDLDRRDRUUU
URULDLUUUDDRRUUULLDDDRDDDDDDLLUULUURDLDRRDRUUUURUL
DLUUUDDRDDDDLLUULULULULLLLUURDLDRRURDLDRURDLDRURDL
DRURDLDRURDLDRRDRUUUURULDLUU