WWWWWWWWWWWWWWW
WWWFW000000WWWW
WWFFW0B00B0W00W
WFFFW0WW0B0W00W
WFFFFF00WBB000W
WWFFFFB0000WB0W
WWWW0WWWWWWW00W
W000B00000000WW
W00B0W00BW0B0WW
W0BWWW0B0W0BB0W
W000SW00WW0000W
WWWWWWWWWWWWWWW