9WWWW99999
9W00WWWWW9
WWB0WW00W9
W00BSB00W9
W000WWB0W9
WWWFWW0WWW
0WFFFB0B0W
0WWFF0000W
99WWWWWWWW