999999WWWWWWWWW
999999W0000000W
999999W0W0W0W0W
999999W00B0BW0W
WWWWWWW000B000W
WFFW00WW0B0BW0W
WFF000WW0B0B00W
WFFW00WW0WWWWWW
WFFW0W0B0B0W999
WFF00000B00W999
W00WWWS00WWW999
WWWW9WWWWW99999