9999WWWWW999
999WW000WWWW
999W0FFR0B0W
WWWW0W0W0S0W
W0000FRFW0WW
W0W0WWBWW0W9
W00000B0B0W9
WW00W000WWW9
9WWWWWWWW999