9999999WWWWWWWW
9999999W00W000W
9WWWWWWW0BBFFFW
9W00000000WFFFW
9W0WWWWWWBWFFFW
WW0W000000WFFFW
W00W0WB0B0WWWWW
W0W0B0B0B0W9999
W0S00B0W00W9999
WWWWWB0BB0W9999
9999W00000W0000
9999WWWWWWW9999