9WWWWWWW99
9WFFFF0W99
WWWFFFBWWW
W00BWB0B0W
W0BB00WB0W
W0000W000W
WWWW0S0WWW
999WWWWW99
9999999999