WWWWWWWWWW
WW0000000W
W000WBWB0W
W0BB00FBFW
W0SWWWFFFW
WWWWWWWWWW