99WWW999
99WFW999
99W0WWWW
WWWB0BFW
WF0BSWWW
WWWWBW99
999WFW99
999WWW99
