WWWW99999WWWW999
W00WWWWWWWFFWWW9
W0B0B0B000FFFFW9
W0B000BB0WRRRFW0
W0B0B0B000FFRFW9
W00B0B0B00RFRFW9
WW0B0B0B0FRFRFWW
W00B0B0B0FRFRFSW
W00B0B0B0WRFWFWW
W0B0B0B00WFFRFW9
W0B000BB0WRRRFW9
W0B0B0B00WFFFFW0
W00WWWWWWWFFWWW9
WWWW99999WWWW999