99999WWWWWWWWW
99999W0000000W
99999W00BWBW0W
9WWWWWW00W0B0W
9W000W0B00B00W
WW0B00000WWW0W
W000WBWWWW000W
W0000B0WWW0WWW
WWWWWFF0SW0WW9
999WFFFB0BB0W9
999WFFFW0000W9
999WFFFWWWWWW9
999WWWWW999999