WWWWWWWWWWW
W0000W0000W
W0BSBBBBB0W
W000000000W
WWWWW0WWWWW
999WF00W999
999WF00W999
999WFFFW999
999WF00W999
999WWWWW999