999WWWWWWW
99WW00W0SW
99W000WB0W
99WB00B00W
99W0BWW00W
WWW0B0W0WW
WFFFFF00W9
WWWWWWWWW9