WWWWW9WWWWWWW
W000WWW00W00W
W00B0000B0S0W
WW0WBWWFWW00W
9W00FFFRF0B0W
9W0BW0WFW0W0W
9WW0000B0000W
99W00WWWWWWWW
99WWWW9999999