RRRURURULRRRDLRDDLURDDDLULRRUULDURUULLLDDLDLLLLUUR
UUURRRRRRRDDUULUURDRRRURDDDUULLLLLDLLLLLLDDDLDDRRR
RURUURRRUULURRRURDDDUULLLDDDLDDRUUUULURRRRURDDULLL
LDDDLLLDRRDRUUUULURRRURDRDLULDDUULLDDDDDDDDLLURDRU
UUUUUULURRRURDDULLLDDDDDDDLUUULURDRUUULURRRRURDLLL
LDDDDLLLDRRDRUUUUULURRRURRDLULDDULLDDDDDLLLLDLLURR
RRRDRUUUUULURRRURDLLLDDDDDLLLLLUURRRRDRUUULURRRURR
DLULDLLDDDDDDDDLLLLUULURRRRDRUUUUULURRRRLLLDDDDDLL
LLDDRRRDRUUUUUUULURRRLLDDDDDDDLLLULURRRDRUUUUULURR