RDDDDDRRLLUURDLDRUULUURDDLDDDDRRURDLLLUUUUURRRDRDR
DRUDDDLURUULLULULLDLDDDDRRRRLLLLUUUUURRRDRDRRDDLUD
LDLLURRURRDDLRUULLDLDLLLURRDRRUURRDDLLLLULLDRURRLL
ULUUURRRDRDULLDRUULLLDDDRDRRUUDDDRRRUULLRRDDLLLULL
ULUUURRRULDDDRURDULLUURDLLLURDRRURLDLLLDDDRDRRDRRR
UUULLRRDDDLLLULLULUUURRRURDULLRRDRRRRURRDLLLLULLDL
LURDLLLURDLDDDRDRRDRRULRRUULDRDDLLLLULLDRRRLULULUU
URRRRRRRRURRDLLLLLDDRULURRRURRDLLLLULDRDDDDDLLLLUL
LDRUULUUURRRULRDRRRRRURRDLLLLDDDDDLLULLRRDRRUUULLD
URRDLURUUULLDLLURRDLLLLURDRDDRRLLUURRDURRRRURDDDDU
UULLLLLLLDDRULURRRRRRURRDLLLLDDDDDLLLUUUULURDDDDDR
RRUULLDURRUUUULRDDLLDURRURRRDDDDDDDRDDLUUUUUUUUULL
LDLLDLDULUULLDRURRDULLULULLDDDDDDDDDUUUUUUUUURRDRD
RRDRRRURRRDDDDDDDDLLLLLLLLLLDLLURRRRRRRRRRRLLLLLLL
LLLUUUUUUUUUURRDRDRRDRRRURRRDDDDDDDRDDLUUUUDDDLLLL
LLLLLLLUUUUUUUUUURRDRDRRDRRRUULDRDLULLLRRRRRRUURDR
DLLLLLLRRRRRDDDDDDDRDDLUUUUUUUUURULULDRDLLL